*******
E     *
* *****
*     *
***** *
*     *
* *** *
*   H *
*******